########################
#                     O#
#     X             ####
#               #      #
#######      X         #
#  O ##         OX#    #
#    ##     OX  O      #
#               X      #
#               P      #
#       #              #
########################
