############### ########
#                     O#
#     X             ####
#               #      #
#######      X         #
#  O ##         OX#    #
#    ##     OX  P       
                       #
#                      #
#       #              #
################ #######
