#########
#O   X  #
# P     #
#   OX  #
#########
