####################################
#                 #      #         #
#                 # #              #
#               # # #              #
#           P   # # #   O          #
#               # # #   X          #
#               # # #              #
#               # # #              #
#               #   #              #
####################################
