########################
#                     O#
#                   ####
#                      #
#######                #
#  O ##         #      #
#    ##         P      #
#                      #
#       XX             #
#       #              #
########################
